41 41 41 41 41 41 41 41 
42 42 42 42 42 42 42 42 
43 43 43 43 43 43 43 43 
44 44 44 44 44 44 44 44 
45 45 45 45 45 45 45 45 
46 46 46 46 46 46 46 46 
80 b5 ff ff ff 7f 00 00 
c0 10 40 00 00 00 00 00

